NO north 
SO south 

WE west 
EA east 


C 52,44,74 

F 74,0,8 

11111111111111111111
10000000000000000001
10000000000000000001
10000000N00000000001
10000000000000000001
10000000000000000001
10000000000000000001
11111111111111111111