NO north    
SO suth 
EA east 
C 52,44,74 
F 74,0,8 
WE west 
EA east 
EA east 
EA east 

11111111111111111111
11111111111111111111
110010000000011111N1
11000000001111111111
11111111111111111111