111111111111
100000000001
100000000001
100000000001
100000000001
100000000001
100111110001
100100000001
1CEP00000001
100000000001
100000000001
111111111111