11111111
10000001
10000001
10010001
10000001
10000001
1CEP0001
11111111
