
NO north 
SO south 

WE west 
EA east 


C 52,44,74 

F 74,0,8 


1111111111111                                
1N000000011                                                                            
11111111111