
NO first
SO Hello
WE There
EA Hi
EA BOO
F 89,9,0
C 89,0,0

11111111111
111100N0011
1111111111                                             