NO /Users/artaveti/Desktop/Cub3D/xpm_files/NO(bluestone).xpm     
SO /Users/artaveti/Desktop/Cub3D/xpm_files/SO(colorstone).xpm 
WE /Users/artaveti/Desktop/Cub3D/xpm_files/WE(redbrick).xpm
EA /Users/artaveti/Desktop/Cub3D/xpm_files/EA(purplestone).xpm 
C 52,44,74 
F 74,0,8

111111
100001
100001
1N0001
111111